9 12
##    #    #
## ## ##   #
#B #  #    #
# ## ##    #
     ##    #
 # ####    #
 # ####    #
   ####    #
A #####    #