###                 ##########
#   ###################   # ##
# ####                # # # ##
# ################### # # # ##
#                     # # # ##
##################### # # # ##
#   ##********        # # # ##
# # ##*### ##*######### # # ##
# #****#   ##B#         # # ##
# #*## ################ # # ##
###*##             #### # # ##
###*############## ## # # # ##
###****         ##    # # # ##
######*######## ####### # # ##
######*####             #   ##
######*####             #   ##
######*####             #   ##
######*####             #   ##
######*####             #   ##
A******#######################
