##    #    #
## ## ##   #
#B #  #    #
#*## ##    #
 **  ##    #
 #*####    #
 #*####    #
 **####    #
A*#####    #
