##    #    #
## ## ##   #
#B #  #    #
#*## ##    #
**   ##    #
*# ####    #
*# ####    #
*  ####    #
A #####    #
